106
brick: something used for building walls, houses and other buildings
gain: an advantage or improvement
attract: to interest you and make you want it
shark: a large sea fish with very sharp teeth and a pointed fin on its back
target: an object, a person or a place that people aim at when attacking; a result that you try to achieve
approach: to come near to somebody / something in distance or time
attack: an act of using violence to try to hurt or kill somebody; to use violence to try to hurt or kill somebody
sharp: having a fine edge or point, especially of something that can cut or make a hole in something
skin: the layer of tissue that covers the body 
strength: the quality of being physically strong
wrap: to put something firmly around something /somebody; to cover something completely in paper or other material
bleed: to lose blood, especially from a wound or an injury
bite: to use your teeth to cut into or through something
defeat: failure to win or to be successful; to win against somebody in a war, competition, sports game, etc.
destroy: to damage something so badly that it no longer exists, works, etc.
intelligent: (of an animal, a being, etc.) able to understand and learn things; good at learning, understanding
struggle: to fight somebody or try to get away from them; to try very hard to do something when it is difficult
sink: to go down below the surface or towards the bottom of a liquid or soft substance
ahead: further forward in space or time; in front
maintain: to make something continue at the same level, standard, etc.; to keep stating that something is true, even though other people do not agree
dramatically: by a strikingly large amount or to a strikingly large extent; greatly
curious: having a strong desire to know about something
shortage: a situation when there is not enough of the people or things that are needed
grain: the small hard seeds of food plants such as wheat, rice, etc.; a single seed of such a plant
decade: a period of ten years
self-sufficient: able to do or produce everything that you need without the help of other people
medal: a flat piece of metal, usually shaped like a coin, that is given to the winner of a competition
outstanding: extremely good; excellent
institute: an organization that has a particular purpose, especially one that is connected with education or a particular profession
request: the action of asking for something formally and politely
atmosphere: the mixture of gases that surrounds the Earth
lack: the state of not having something or not having enough of something
clue: some words or a piece of information that helps you find the answers to a game or a question
literature: pieces of writing that are valued as works of art
failure: a person or thing that is not successful; lack of success in doing or achieving something
realistic: accepting in a sensible way what it is actually possible to do or achieve in a particular situation 
professional: doing something as a paid job rather than as a hobby
false: wrong; not correct or true
permanently: lasting for a long time or for all time in the future
setback: a difficulty or problem that delays or prevents something or makes a situation worse
title: the name of a book, poem, painting, piece of music, etc.
cell phone: (American English) a mobile phone
in addition: used when you want to mention another person or thing after something else
nationality: one's legal right to belong to a nation
journal: a written record of the things you do, see, etc. every day; a newspaper or magazine
authority: the power to give orders to people the power to influence people because they respect your knowledge or official position
journalist: a reporter
annual: happening or done once every year
spot: to see or notice a person or thing, especially suddenly or when it is not easy to do so
entirely: in every way possible; completely
error: a mistake, especially one that causes problems or affects the result of something
emotion: a strong feeling such as love, fear or anger
female: being a woman or a girl
illustrate: to make the meaning of something clearer by using examples, pictures, etc.; to use pictures, photographs, diagrams, etc. in a book, etc.
ensure: to make sure that something happens or is definite
affect: to produce a change in somebody / something
permission: the act of allowing somebody to do something
subway: an underground railway / railroad system in a city
average: ordinary; not special; typical or normal
confirm: to state or show that something is definitely true or correct, especially by providing evidence
click: to press a button on the mouse to choose something on the computer screen; to make or cause something to make a short sharp sound
flexible: able to change to suit new conditions or situations
perceive: to notice or become aware of something
soccer: (American English) football
horrible: very bad or unpleasant
joyfully: happily
calm: quiet and peaceful
breathe: to take air into your lungs and send it out again through your nose or mouth
merrily: in a happy, cheerful way
release: the act of making something available to the public; to allow (news, etc) to be made known
innovation: the introduction of new things, ideas or ways of doing something
outline: to give a description of the main facts or points involved in something
collection: a group of objects, often of the same sort, that have been collected
committee: a group of people chosen to do a particular job, make decisions, etc.
announce: to make something known publicly
entry: something that you do, write or make to take part in a competition
publish: to produce a book, magazine, CD-ROM, etc. and sell it to the public
plot: the series of events that form the story of a novel, play, film / movie, etc.
super: extremely
soundtrack: all the music, speech and sounds that are recorded for a film / movie
character: a person or an animal in a book, play or film / movie
civilization: a state of human society that is very developed and organized
novel: a story long enough to fill a complete book, in which the characters and events are usually imaginary
astronaut: a person whose job involves travelling and working in a spacecraft 
system: a group of things, pieces of equipment, etc. that are connected or work together; an organized set of ideas or theories or a particular way of doing something
crash: to hit something hard while moving, causing noise and / or damage
disaster: an unexpected event, such as a very bad accident, a flood or a fire, that kills a lot of people or causes a lot of damage
pack: to fill something with a lot of people or things; to put clothes, etc. into a bag
entertaining: interesting and amusing
throughout: during the whole period of time of something
photographer: a person who takes photographs, especially as a job
rare: not done, seen, happening, etc. very often
region: a large area of land
custom: an accepted way of behaving or of doing things in a society or a community
overall: including everything or everyone; in total; generally
ordinary: not unusual or different in any way
province: one of the areas that some countries are divided into with its own local government
flour: a fine white or brown powder made from grain, especially wheat, and used in cooking for making bread, cakes, etc.
participate in: to take part in or become involved in an activity
ought to: used to say what is the right thing to do
appeal to: to attract or interest somebody
stewed beef: a dish in which beef is slowly cooked in liquid, which results in a thick, soup-like food
soy sauce: a thin dark brown sauce that is made from soya beans and has a salty taste
steamed bun: a flour dish that is cooked by hot steam
staple food: a basic type of food
focus on: to give attention, effort, etc. to one particular subject, situation or person